                                                                         
                    +-------+                                            
                    |.......|                                            
                    |.......###############    +------------+            
                    +-------+             #    |............|            
                                          #    |............|            
                  +------------+          ######............|            
                  |............|               |............|            
                  |............######          +----------#-+            
                  +--#---------+    #                     #              
      #              #              #######################              
      #         +----#-----------+  #                                    
      #         |................####                                    
      ###########................|                                       
                |.....+-----+....|           +----------+                
                |.....|     |....|           |..........|                
                |.....+-----+....|           |..........|                
                |................#############..........+--------+       
                |................|           |...................|       
                +----------------+           +-------------------+       
                                                                         
